111111111111111111111111111111111111111111111111111
1P0000000000011111111111111111111111111111111111111
1CCC00000000011111111111111111111111111111111111111
100000000000111111111111111111111111111111111111111
100000000000000111111111111111111111111111111111111
100000000000000111011111111111001111111111111111111
111111111000000000111111111110011111111111111111111
111111111000000110001111111110111111111111111111111
111111111111111011100000001100111111111111111111111
111111111111101111111111100001111111111111111111111
111111111111101111111111110011111111111111111111111
111111111111011111111111111000111111111111111111111
111111111111111111111111111110011111111111111111111
111111111111111111111111111111001111111111111111111
111111111110011111111111111111000011111111111111111
111111111110011111111111111111011000011111111111111
111111111111111111111111111110011111011111111111111
111111111111111111111111111110111100011111111111111
1111111111111111111111111111111111011E0011111111111
111111111111111111111111111111111101111011111111111
111111111111111111111111111111111100000011111111111
111111111111111111111111111111111111111111111111111
111111111111111111111111111111111111111111111111111
111111111111111111111111111111111111111111111111111
111111111111111111111111111111111111111111111111111
111111111111111111111111111111111111111111111111111
111111111111111111111111111111111111111111111111111
111111111111111111111111111111111111111111111111111