1111111111111111111111111111111111111
1P00000000000111111111111111111111111
1CCC000000000111111111111111111111111
1000000000001111111111111111111111111
1000000000000001111111111111111111111
10000000000000E1110111111111110011111
1111111111111111111111111111111111111
